! Kilobolt Studios
! http://kilobolt.com
! Game Development Tutorial - Unit 3
! Q-Bot Level 1
! # = Tile Legend 
! 5 = TileDirt
! 8 = GrassTop
! 2 = GrassBot
! 4 = GrassLeft
! 6 = GrassRight 
tttttttttttttttttttttttttt
000000000000U0000000000000
00000000000000000000000000
0000t00000000t0000000000T0
00000000000000000000000000
00000000000000000t0000t000
00M00000000000000000000000
00000000000000000000000000
t00000000t0000t000000h0000
00000000000000000000000000
00000000000000M00000T00000
00000000000000000000000000
0000t000t0000t000000000000
00000P00000000P00000t00000
00000000A000000000tt000000
000000000000000000tttt0000
00t000B0000t00000000t00000
00000000000000000000000000
000000a000000000t000000B00
00000000000000000000000000
00000000000000000000000000
t0T0000t000000t000P0000000
000000000000t0000000000000
00000t00000000000000000000
tttttttttttttttttttttttttt
