! Kilobolt Studios
! http://kilobolt.com
! Game Development Tutorial - Unit 3
! Q-Bot Level 1
! # = Tile Legend 
! 5 = TileDirt
! 8 = GrassTop
! 2 = GrassBot
! 4 = GrassLeft
! 6 = GrassRight 
ttttttttttttttttttttttttt
0000000000000000000000000
0000000000000000000000000
0000t00000000t0000000000T
0000000000000000000000000
00000000000000000t0000t00
00M0000000000000000000000
0000000000000000000000000
t00000000t0000t000000h000
0000000000000000000000000
00000000000000M00000T0000
0000000000000000000000000
0000t000t0000t00000000000
00000P00000000P00000t0000
00000000A000000000tt00000
000000000000000000tttt000
00t000B0000t00000000t0000
0000000000000000000000000
000000a000000000t000000B0
0000000000000000000000000
0000000000000000000000000
t0T0000t000000t000P000000
000000000000t000000000000
00000t0000000000000000000
ttttttttttttttttttttttttt
